R 1020 1080
NO textures/redbrick.xpm
WE textures/mossy.xpm
SO textures/greystone.xpm
EA textures/bluestone.xpm

S textures/barrel.xpm

C 0,0,255
F 0,255,255

111111111111111111111111
12222122222222222222222111111111111111111111111111111
12002100000000000000000000000000000000000000000000001
12002100000000000000000111111111111111111111111111101
120000000000000000000001                          101
120221000000000000000001                          101
110111111100001111011111                          101
100000000000000000000001                          101
100000000000000000000001                          101
100000000000000001100001                          101
10E000000000000000000001                          101
100000000000000000000001                          101
100000000000000000000001                          101
100000000000000000000001                          101
100000000000000000000001                          101
100000000000000000000001                          101
100000000000000000000001                          101
122200222222222222222201                          101
111110111111111111111111                          101
100000000000000000000001                          101
10000000000000000000000111111111111111111111111111101
10000000000000000000000000000000000000000000000000001
10000000000000000000000111111111111111112222001111111
111111111111111111111111               1111111

