R 1080 650
SO                    ./textures/eagle.xpm
NO ./textures/redbrick.xpm
WE  ./textures/mossy.xpm
EA ./textures/bluestone.xpm

S ./textures/barrel.xpm

F 255,255,255
C 0,0,0
111111111111111111111111
122222202222022022202221
100000000000000000000001
100000000000000000000001
10000011111000010101001
10000010001000000000001
100000101010000100010001
100000110010000000000001
100000110110000101010001
100000000000000000000001
100000000000000000000001
1000000000000000000000011
100000000001000000000001
1000000000010000000000011
100000000001000000000001
100000000000000000000001
11111111100000N000000001
110100001000000020020001
100000101000000000000001
110100001000000000000001
110111111000000000000001
110000000000000000000001
1111111110000000020000001
111111111111111111111111
